doorbell	WholePart
mailbox	Purpose
oilcan	Purpose	
sunshine	WholePart
bookshelf	Purpose
brakeman	ActivityActor
bluebell	Specialization
bookkeeper	ActivityActor
haircut	WholePart
footnote	Purpose
housekeeper	ActivityActor
landmark	WholePart
postoffice	WholePart
policeman	ActivityActor
railway	Composition
shoemaker	ActivityActor
waterway	Specialization
website	Purpose
username	WholePart
handgun	Purpose	
footstep	WholePart
warship	Purpose
seaman	ActivityActor
schoolroom	WholePart
buttermilk	HalfHalf
firefly	Comparison
handbook	Purpose
blackberry	Specialization
bloodpressure	WholePart
salesperson	ActivityActor
wallpaper	Purpose
fireplace	Purpose
teaspoon	Purpose
songwriter	ActivityActor
toothpaste	Purpose
weekend	WholePart
fingerprint	WholePart
freezone	Specialization
briefcase	Purpose
dragonship	Comparison
postman	ActivityActor
toolbox	Purpose
snowboard	Purpose
battleship	Purpose
teacup	Purpose
seafood	PlaceObject
woodpile	WholePart
blockhead	Specialization
teamplayer	WholePart
bigbang	Specialization