doorbell	WholePart
mailbox	Purpose
oilcan	-
sunshine	-
bookshelf	WholePart
brakeman	ActivityActor
bluebell	Specialization
bookkeeper	ActivityActor
haircut	-
footnote	-
housekeeper	ActivityActor
landmark	Purpose
postoffice	Purpose
policeman	ActivityActor
railway	ActivityActor
shoemaker	ActivityActor
waterway	WholePart
website	Purpose
username	WholePart
handgun	WholePart
footstep	-
warship	Purpose
seaman	Purpose
schoolroom	WholePart
buttermilk	Purpose
firefly	Purpose
handbook	Purpose
blackberry	Specialization
bloodpressure	Purpose
salesperson	ActivityActor
wallpaper	Purpose
fireplace	Purpose
teaspoon	Purpose
songwriter	WholePart
toothpaste	Purpose
weekend	WholePart
fingerprint	Comparison
freezone	Specialization
briefcase	Specialization
dragonship	Purpose
postman	ActivityActor
toolbox	Purpose
snowboard	Purpose
battleship	HalfHalf
teacup	Purpose
seafood	PlaceObject
woodpile	WholePart
blockhead	WholePart
teamplayer	WholePart
bigbang	Specialization